ZOOOOOOOOOOOOOOOOOOOOOOOOOOOZ
L___________________________I
L___________________________I
L___________________________I
L___________________________I
L___________________________I
L___________________________I
L___________________________I
L___________________________I
L______________________ZXZ__I
L______________________IZL__I
L_____________ZXXXZ____ZOZ__I
L___________Z_I___L_________I
ZXXXXXXXXXXXXXZXXXXXXXXXXXXXZ